{
"map_left": [
	"w",	"w",	"w",	"w",	"w",	"w",	"w",	"w",	"w",	"w",		
	"w",	"",		"",		"",		"",		"", 	"", 	"", 	"",		"w",		
	"w",	"",		"",		"",		"",		"", 	"", 	"", 	"",		"w",		
	"w",	"",		"",		"",		"",		"", 	"", 	"", 	"",		"w",		
	"w",	"",		"",		"w",		"",		"w", 	"", 	"", 	"",		"w",		
	"w",	"",		"",		"w",		"p",		"w", 	"", 	"", 	"",		"w",		
	"w",	"",		"",		"w",		"w",		"w", 	"", 	"", 	"",		"w",		
	"w",	"",		"",		"",		"",		"", 	"", 	"", 	"",		"w",		
	"w",	"",		"",		"",		"",		"", 	"", 	"", 	"",		"w",
	"w",	"w",	"w",	"w",	"w",	"w",	"w",	"w",	"w",	"w"
],
"map_right": [
	"w",	"w",	"w",	"w",	"w",	"w",	"w",	"w",	"w",	"w",		
	"w",	"",		"",		"",		"",		"", 	"", 	"", 	"",		"w",		
	"w",	"",		"",		"",		"g",		"", 	"", 	"", 	"",		"w",		
	"w",	"",		"",		"",		"",		"", 	"", 	"", 	"",		"w",		
	"w",	"",		"",		"",		"b",		"", 	"", 	"", 	"",		"w",		
	"w",	"",		"",		"",		"",		"", 	"", 	"", 	"",		"w",		
	"w",	"",		"",		"",		"",		"", 	"", 	"", 	"",		"w",		
	"w",	"",		"",		"",		"",		"", 	"", 	"", 	"",		"w",		
	"w",	"",		"",		"",		"",		"", 	"", 	"", 	"",		"w",
	"w",	"w",	"w",	"w",	"w",	"w",	"w",	"w",	"w",	"w"
]
}