{
"map_left": [
	"w",	"w",	"w",	"w",	"w",	"w",	"w",	"w",	"w",	"w",		
	"w",	"",		"",		"",		"",		"", 	"", 	"", 	"",		"w",		
	"w",	"",		"",		"",		"",		"", 	"", 	"", 	"",		"w",		
	"w",	"",		"",		"", 	"", 	"", 	"", 	"", 	"",		"w",		
	"w",	"w", 	"w",	"w", 	"w", 	"w", 	"w", 	"w", 	"w", 	"w",		
	"w",	"p", 	"", 	"", 	"", 	"", 	"", 	"", 	"", 	"w",		
	"w",	"w", 	"w", 	"w", 	"w", 	"w", 	"w", 	"w", 	"w", 	"w",		
	"w",	"",		"",		"",		"",		"", 	"", 	"", 	"",		"w",		
	"w",	"",		"",		"",		"",		"", 	"", 	"", 	"",		"w",
	"w",	"w",	"w",	"w",	"w",	"w",	"w",	"w",	"w",	"w"
],
"map_right": [
	"w",	"w",	"w",	"w",	"w",	"w",	"w",	"w",	"w",	"w",		
	"w",	"",		"",		"",		"",		"", 	"", 	"", 	"",		"w",		
	"w",	"",		"",		"",		"",		"", 	"", 	"", 	"",		"w",		
	"w",	"",		"",		"",		"",		"", 	"", 	"", 	"",		"w",		
	"w",	"",		"",		"",		"",		"", 	"", 	"", 	"",		"w",		
	"w",	"",		"",		"b", 	"g", 	"", 	"", 	"b", 	"g", 	"w",		
	"w",	"",		"",		"",		"",		"", 	"", 	"", 	"",		"w",		
	"w",	"",		"",		"",		"",		"", 	"", 	"", 	"",		"w",		
	"w",	"",		"",		"",		"",		"", 	"", 	"", 	"",		"w",
	"w",	"w",	"w",	"w",	"w",	"w",	"w",	"w",	"w",	"w"
]
}